########################################################
#            ##                          ##            #
# #### ##### ## ##### #### ## #### ##### ## ##### #### #
# #--# #---# ## #---# #--# ## #--# #---# ## #---# #--# #
# #### ##### ## ##### #### ## #### ##### ## ##### #### #
#                                                      #
# #### ## ######## ## #### ## #### ## ######## ## #### #
# #### ## ######## ## #### ## #### ## ######## ## #### #
#      ##    ##                          ##    ##      #
###### ##### ## ##### ############ ##### ## ##### ######
-----# ##### ## ##### #----------# ##### ## ##### #-----
-----# ##          ## #----------# ##          ## #-----
-----# ## ######## ## ############ ## ######## ## #-----
###### ## #------# ## #          # ## #------# ## ######
          #------#                    #------#          
###### ## #------# ## #          # ## #------# ## ######
-----# ## ######## ## ############ ## ######## ## #-----
-----# ##          ## #----------# ##          ## #-----
-----# ## ######## ## #----------# ## ######## ## #-----
###### ## ######## ## ############ ## ######## ## ######
#            ##                          ##            #
# #### ##### ## ##### #### ## #### ##### ## ##### #### #
# #### ##### ## ##### #### ## #### ##### ## ##### #### #
#   ##                ##        ##                ##   #
### ## ## ######## ## ## ###### ## ## ######## ## ## ###
### ## ## ######## ## ## ###### ## ## ######## ## ## ###
#      ##    ##    ##              ##    ##    ##      #
# ########## ## ########## ## ########## ## ########## #
# ########## ## ########## ## ########## ## ########## #
#                                                      #
########################################################