---------------------------
|        ####  #####      |
|                         |
|          #####          |
|    #####                |
|             %%%%%%%%%%  |
---------------------------