###########################
#        ####  #####      #
#                         #
#          #####          #
#    #####                #
#    #####                #
#    #####                #
#    #####                #
#             %%%%%%%%%%  #
###########################