############################
#            ##            #
# #### ##### ## ##### #### #
# #--# #---# ## #---# #--# #
# #### ##### ## ##### #### #
#                          #
# #### ## ######## ## #### #
# #### ## ######## ## #### #
#      ##    ##    ##      #
###### ##### ## ##### ######
-----# ##### ## ##### #-----
-----# ##          ## #-----
-----# ## ###  ### ## #-----
###### ## #      # ## ######
          #      #          
###### ## #      # ## ######
-----# ## ######## ## #-----
-----# ##          ## #-----
-----# ## ######## ## #-----
###### ## ######## ## ######
#            ##            #
# #### ##### ## ##### #### #
# #### ##### ## ##### #### #
#   ##                ##   #
### ## ## ######## ## ## ###
### ## ## ######## ## ## ###
#      ##    ##    ##      #
# ########## ## ########## #
# ########## ## ########## #
#                          #
############################